Авилова	Виктория	Аркадивна	Россия, г. Волгоград, Мичурина ул., д. 10 кв.209
Ховрунов	Павел	Ефремович	Россия, г. Артем, Набережная ул., д. 8 кв.79
Лыткин	Степан	Ефимович	Россия, г. Новороссийск, Центральная ул., д. 18 кв.216
Кондюрин	Максим	Леонтьевич	Россия, г. Тамбов, Школьная ул., д. 23 кв.48
Листунов	Юрин	Егорович	Россия, г. Старый Оскол, Вишневая ул., д. 6 кв.162
Усилова	Ирина	Арсеньевна	Россия, г. Ковров, Молодежная ул., д. 13 кв.25
Алленов	Степан	Ираклиевич	Россия, г. Пермь, Космонавтов ул., д. 18 кв.80
Илюшкин	Антон	Федотович	Россия, г. Кострома, Вишневая ул., д. 11 кв.12
Бабина	Анастасия	Степановна	Россия, г. Шахты, Березовая ул., д. 21 кв.13
Арсеньев	Павел	Валерьевич	Россия, г. Петрозаводск, Якуба Коласа ул., д. 6 кв.185
Лагутина	Анфиса	Трофимовна	Россия, г. Евпатория, Парковая ул., д. 19 кв.91
Тупицына	Наталия	Герасимовна	Россия, г. Шахты, Дзержинского ул., д. 18 кв.101
Цейдлерина	Клавдия	Иннокентьевна	Россия, г. Щёлково, Западная ул., д. 23 кв.85
Жукова	Ксения	Павловна	Россия, г. Белгород, Сельская ул., д. 12 кв.119
Дернова	Елизавета	Вячеславовна	Россия, г. Новокуйбышевск, Дружбы ул., д. 11 кв.104
Ипатьева	Мила	Николаевна	Россия, г. Северодвинск, Социалистическая ул., д. 13 кв.217
Грабарь Тимофей	Евгениевич	Россия, г. Владимир, Якуба Коласа ул., д. 18 кв.148
Фоменкова	Альбина	Акимовна	Россия, г. Кызыл, Почтовая ул., д. 16 кв.35
Трушевская	Анна	Всеволодовна	Россия, г. Первоуральск, 17 Сентября ул., д. 15 кв.40
Никишина	Анжела	Викторовна	Россия, г. Одинцово, Калинина ул., д. 22 кв.122
Богоявленская	Виктория	Вениаминовна	Россия, г. Саратов, Приозерная ул., д. 10 кв.26
Бармыкин	Ефим	Дмитриевич	Россия, г. Назрань, Парковая ул., д. 25 кв.162
Мартюшов	Лев	Валерианович	Россия, г. Смоленск, Дорожная ул., д. 25 кв.37
Щегельский	Арсений	Иванович	Россия, г. Жуковский, Сельская ул., д. 11 кв.163
Ионова	Юлия	Константиновна	Россия, г. Химки, Октябрьская ул., д. 2 кв.192
Рамазанов	Александр	Климентьевич	Россия, г. Орск, Первомайский пер., д. 23 кв.203
Кривчикова	Таисия	Прохоровна	Россия, г. Омск, Колхозная ул., д. 17 кв.77
Чудова	Милана	Лльвона	Россия, г. Каспийск, Вишневая ул., д. 2 кв.139
Бонч-Бруевич	Анастасия	Данииловна	Россия, г. Керчь, Школьный пер., д. 13 кв.188
Шишкарёв	Афанасий	Степанович	Россия, г. Ярославль, Победы ул., д. 16 кв.154
Ахременко	Леонтий	Георгиевич	Россия, г. Кемерово, Пролетарская ул., д. 19 кв.204
Ванина	Настасья	Вячеславовна	Россия, г. Королёв, Озерная ул., д. 4 кв.219
Ярмоленко	Галина	Захаровна	Россия, г. Оренбург, Солнечная ул., д. 1 кв.54
Ермолаева	Светлана	Аркадивна	Россия, г. Новочеркасск, Речная ул., д. 10 кв.72
Сарнычев	Венедикт	Юрьевич	Россия, г. Серпухов, Заречная ул., д. 8 кв.13
Кожуров	Семен	Кириллович	Россия, г. Тюмень, Октябрьская ул., д. 18 кв.180
Евдокимова	Варвара	Петровна	Россия, г. Магнитогорск, Березовая ул., д. 15 кв.182
Шверника	Ярослава	Семеновна	Россия, г. Дербент, Школьная ул., д. 13 кв.99
Митасова	Инна	Михаиловна	Россия, г. Волгодонск, Интернациональная ул., д. 24 кв.60
Фурманов	Константин	Ефремович	Россия, г. Чебоксары, Луговая ул., д. 15 кв.122
Кузаева	Юлиана	Венедиктовна	Россия, г. Нефтекамск, Южная ул., д. 21 кв.65
Синицына	София	Серафимовна	Россия, г. Находка, Дружная ул., д. 3 кв.98
Ярин	Валентин	Филиппович	Россия, г. Элиста, Радужная ул., д. 16 кв.91
Яманова	Елена	Венедиктовна	Россия, г. Пермь, Восточная ул., д. 19 кв.187
Зинченко	Валентин	Афанасьевич	Россия, г. Йошкар-Ола, Комсомольская ул., д. 2 кв.25
Куприянов	Прохор	Кириллович	Россия, г. Черкесск, Комсомольская ул., д. 6 кв.64
Игнатенко	Татьяна	Васильевна	Россия, г. Таганрог, Железнодорожная ул., д. 20 кв.70
Трунин	Яков	Валентинович	Россия, г. Курган, Пушкина ул., д. 18 кв.122
Лоськова	Марьяна	Евгеньевна	Россия, г. Нижневартовск, Красноармейская ул., д. 19 кв.121
Веденеев	Ефим	Елизарович	Россия, г. Грозный, Мира ул., д. 18 кв.151
Зуйков	Антон	Прохорович	Россия, г. Киров, Школьная ул., д. 22 кв.32
Снеткова	Лидия	Артемова	Россия, г. Воронеж, Лесная ул., д. 8 кв.37
Кошкова	Елизавета	Макаровна	Россия, г. Бердск, Школьный пер., д. 13 кв.171
Изотов	Сергей	Юринович	Россия, г. Благовещенск, Хуторская ул., д. 13 кв.156
Козарис	Варвара	Васильевна	Россия, г. Бийск, Цветочная ул., д. 12 кв.168
Сагадеева	Настасья	Ипполитовна	Россия, г. Реутов, Первомайская ул., д. 5 кв.83
Жербин	Иннокентий	Феодосивич	Россия, г. Ковров, Железнодорожная ул., д. 12 кв.39
Иньшов	Арсений	Савванович	Россия, г. Арзамас, Озерный пер., д. 14 кв.124
Бородин	Яков	Федотович	Россия, г. Новочебоксарск, Дзержинского ул., д. 10 кв.204
Мишуринский	Севастьян	Филиппович	Россия, г. Ангарск, Набережная ул., д. 2 кв.121
Суснин	Георгий	Федорович	Россия, г. Ставрополь, Радужная ул., д. 6 кв.69
Кутюков	Петр	Константинович	Россия, г. Ангарск, Сельская ул., д. 8 кв.172
Ухов	Давид	Николаевич	Россия, г. Ярославль, Молодежная ул., д. 22 кв.187
Вазов	Прохор	Егорович	Россия, г. Владивосток, Партизанская ул., д. 2 кв.200
Щеткин	Герман	Никитьевич	Россия, г. Екатеринбург, Школьный пер., д. 4 кв.30
Щередина	Милана	Фадеевна	Россия, г. Нижний Новгород, Молодежный пер., д. 2 кв.111
Канкия	Иван	Кириллович	Россия, г. Череповец, Ленина В.И.ул., д. 4 кв.180
Маринкина	Ирина	Васильевна	Россия, г. Якутск, Полевая ул., д. 8 кв.141
Карякин	Георгий	Юлианович	Россия, г. Норильск, Сельская ул., д. 5 кв.212
Шастин	Кирилл	Викторович	Россия, г. Волжский, Новоселов ул., д. 6 кв.188
Макаров	Федор	Тимофеевич	Россия, г. Петрозаводск, Ленина В.И.ул., д. 14 кв.125
Куклова	Людмила	Романовна	Россия, г. Одинцово, Березовая ул., д. 14 кв.217
Чуприна	Евгения	Ефимовна	Россия, г. Новосибирск, Дружная ул., д. 4 кв.42
Машукова	Дарья	Федоровна	Россия, г. Саранск, Ленина ул., д. 8 кв.76
Достовалова	Вероника	Евгеньевна	Россия, г. Долгопрудный, Партизанская ул., д. 15 кв.22
Шувалов	Семен	Романович	Россия, г. Абакан, Юбилейная ул., д. 8 кв.186
Форопонов	Трофим	Степанович	Россия, г. Пятигорск, Якуба Коласа ул., д. 4 кв.25
Погодова	Анастасия	Захаровна	Россия, г. Абакан, Дорожная ул., д. 12 кв.18
Гусляков	Иван	Арсеньевич	Россия, г. Орёл, Центральный пер., д. 16 кв.178
Черных	Зоя	Степановна	Россия, г. Братск, Дружная ул., д. 18 кв.118
Троицкая	Нонна	Наумовна	Россия, г. Великий Новгород, Луговой пер., д. 24 кв.55
Жвиков	Савва	Львович	Россия, г. Рубцовск, Полевой пер., д. 3 кв.197
Яцкевича	Клара	Степановна	Россия, г. Хасавюрт, Парковая ул., д. 16 кв.171
Канунникова	Юлиана	Игнатьевна	Россия, г. Северск, Шоссейная ул., д. 17 кв.29
Рагозин	Антон	Никанорович	Россия, г. Челябинск, Школьный пер., д. 2 кв.39
Цвиленев	Тимофей	Кириллович	Россия, г. Благовещенск, Дзержинского ул., д. 5 кв.186
Чучанов	Егор	Саввеевич	Россия, г. Хабаровск, Октябрьский пер., д. 17 кв.158
Кабисова	Римма	Степановна	Россия, г. Салават, Рабочая ул., д. 17 кв.61
Вахрушев	Павел	Васильевич	Россия, г. Копейск, Партизанская ул., д. 25 кв.184
Беломестова	Таисия	Трофимовна	Россия, г. Кисловодск, Пионерская ул., д. 18 кв.123
Кувшинова	Марина	Леонтьевна	Россия, г. Ульяновск, Заслонова ул., д. 14 кв.144
Чечурова	Светлана	Георгьевна	Россия, г. Пенза, Набережная ул., д. 22 кв.8
Стеблева	Марина	Трофимовна	Россия, г. Балашиха, Пушкина ул., д. 16 кв.50
Кузинова	Маргарита	Климентьевна	Россия, г. Ульяновск, Партизанская ул., д. 3 кв.203
Чуличков	Кузьма	Михаилович	Россия, г. Одинцово, Школьный пер., д. 13 кв.2
Непеина	Алла	Ефимовна	Россия, г. Новочебоксарск, Приозерная ул., д. 17 кв.90
Молодых	Людмила	Константиновна	Россия, г. Орехово-Зуево, Речная ул., д. 2 кв.147
Шеломов	Петр	Павлович	Россия, г. Щёлково, Советский пер., д. 24 кв.144
Гачева	Полина	Евгеньевна	Россия, г. Мурманск, Садовая ул., д. 1 кв.109
Галицкова	Серафима	Феоктистовна	Россия, г. Бийск, Озерная ул., д. 3 кв.90